type octile
height 96
width 128
map
...............................................@@@............................@@@..................@@@..........................
..............................................@@@@............................@@@@.................@@@..........................
.............................................@@@@@............................@@@@................@@@@..........................
@@........................................@@@@@@..............................@@@@............@@..@@............................
@@@@......................................@@@@................................@@@@@@........@@@@@...............................
@@@@@@@@@@.@@@............................@@@@..................................@@@@......@@@@@@@...............................
..@@@@@@@@@@@@@@@@@.....................@@@@@@................................@@@.........@@@@@@@...............................
....@@@@@@@@@@@@@@@@@@..................@@@@......................@@@@........@@@............@@@............................@@@@
..............@@@@@@@@..................@@@@....................@@@@@@@@......@@@@.............@@@........................@@@..@
..................@@@@....@@@@........@@@@@@.....................@@@@@@@@@......@@..@@...........@@@....................@@@.....
..................@@@@@@.@@@@@@@....@@@@@@......................@@@@@@@@@@.........@@@@@........@@@@..............@@@@@@@.......
....................@@@@@@@@@@@@@@..@@@@......................@@@@@@@@@@@..........@@@@@@@......@@@@............@@@..@@.........
......................@@@@....@@@@..@@@@............@@@@@@@.@@@@@@@@@@@@@@.........@@@@@@@.........@@@..........@@@.............
..............................@@@@..@@@@..........@@@@@@@@@@@@@@@@@@@@..............@@@...........@@@@..........@@@@............
..............................@@@@@@@@@@....@@@@@@@@@@@@@@@@@@@@@@@@@@@...........@@@.............@@@@............@@..@@........
...............................@@@@@@@@@..@@@@@@@@@@@@@@@@@@@@@@@@@@@@@.........@@@...............@@@@...............@@@@@......
............................@@@@@@@@@@@@@@@@@@@@@@@@@@@@@@@@@@@@..............@@@...............@@@@@@...............@@@@@@@....
...........................@@@@@@@@@@@@@@@@@@@@@@@@@@@@@@@@@@@..............@@@.................@@@@@@...............@@@@@@@....
..........................@@@@@@@@@@@@@@@@@@@@@@@@@@@@@@@@@@................@@@@................@@@@@@................@@@.......
..............................@@@@@@@@@@@@@@@@@@@@@@@@@@@@..................@@@@...............@@@@@@@................@@@@......
............................@@@@@@@@@@@@@@@@@@@@@@@@......................@@@...........@@@@@@@@@@@@..@@@@@@@@........@@@@......
............................@@@@@@@@@@@@@@@@@@@@@@......................@@@............@@@@@@@@@..@@@@@..@@..@@@@@@@@@@.........
................................@@@@@@@@@@@@@@@@..................@@@@@@@...........@@@@@@@@@@@@@@@@@..........@@..@@...........
..............................@@@@@@@@@@@@@@@@@.................@@@..@@............@@@@@@@@@@@@@@@@@@@..........................
..............................@@@@@@@@@@@@@@..................@@@...............@@@@@@@@@@@@@@@@@@@@@@..........................
..............................................................@@@@............@@@@@@@@@@@@..@@@..@@.............................
........................................................@@@@@@@@@@@.........@@@@@@@@@@@@..@@@...................................
......................................................@@@@@@@@@@@@@@......@@@@@@@@@@@@....@@@@..................................
....................................................@@@@@@@@@@@@@@@@..@@..@@@@@@@@@@..@@@@@@@@..............@@@.................
....................................................@@@@@@@@@@.......@@@@@@@@@@@@...@@@..@@...........@@@@@@@@@@................
....................................................@@@@@@@@.........@@@@@@@@@@@@@@@@@@@............@@@@@@@@@@@@..@@............
..................................................@@@@@@@@@@@@.......@@@@@@@@@@@@@@@@@@@............@@@@@@@@.....@@@@@@@@@@@@@@@
....................................@@@@@@@@.....@@@@@@@@@@@@@..........@@@@@@@@..@@@..................@@@.......@@@@@@@@@@@@@@@
..................................@@@@@@@@@@@@@@@@@@@@@@@@............@@@@@@@@..@@@...................@@@@.......@@@@@@@@@@@@@@@
................................@@@@@@@@@@@@@@@@@@@@................@@@@@@@@@@@@@@@@............@@@@@@@@@@...................@..
@@............................@@@@@@@@@@@@@@@@@@@@.................@@@@@@@@@@@@@@@@@..........@@@@@@@@@@........................
@@.............................@@@@@@@@@@@@@@@@@..................@@@@@@@@@@....@@@.........@@@@@@@@@@..........................
@..............................@@@@@@@@@@@@@@@@@@.................@@@@@@@@@@@...@@@@......@@@@@@@@..............................
............................@@@@@@@@@@@@@@@@@@@@@@...............@@@@@@@@@@@@.....@@..@@@@@@@@.@................................
.............................@@@@@@@@@@@@@.....................@@@@@@@@@@@...........@@@@@@@..@@@@..............................
........................@@@@@@@@@@@@@@@@....................@@@@@@@@@@@@.............@@@@@@@@@@@@@@.............@@@@@@@@........
......................@@@@@@@@@@@@@@@@....................@@@@@@@@@@@@...............@@@@@@@@@@@@@@...........@@@@@@@@@@@@......
............@@@@.@@@@@@@@@@@@@@@@@@@....................@@@@@@@@@@@@................@@@.@@@@@@@@@@@@.........@@@@@@@@@@@@@......
@..........@@@@@@@@@@@@@@@@@@@@@@@@@@@.................@@@@@@@@@@@.................@@@@@@@@@@@@@@@@..........@@@@@@@@@@@@.......
@.......@@@@@@@@@@@@@@@@@@@@@@@@@@@@@@...............@@@@@@@@@@@................@@@@@@@@@@@@@@@@............@@@@@@@@@@@@@@......
@@@@@@@@@@@@@@@@@@@@@@@@@@@@@@@@@@................@@@@@@@@@@@@.................@@@@@@@@@@@@@@@.............@@@@@@@@@@@..........
@@@@@@@@@@@@@@@@@@@@@@@@@@@@@@@@@@@.............@@@@@@@@@@@@................@@@@@@@@@@@@@@@@............@@@@@@@@@@@@@@@.........
@@@@@@@@@@@@@@@@@@@@@@@@@@@@@@@@@@@@..........@@@@@@@@@@@@@@@@............@@@@@@@@@@@@@@@@............@@@@@@@@@@@@@@@@@.........
@@@@@@@@@@@@.........@@@@@@@@@@@...............@@@@@@@@@@@@@@@...........@@@@@@@@@@@@@@@.............@@@@@@@@@@@@@@@............
@@@@@@@@@@........@@@@@@@@@@@@@@@@............@@@@@@@@@@@@..............@@@@@@@@@@@@@@...............@@@@@@@@@@@@@..............
@@@@@@@@...........@@@@@@@@@@@@@@@..........@@@@@@@@@@@@................@@@@@@@@@@@@................@@@@@@@@@@@@................
..................@@@@@@@@@@@@............@@@@@@@@@@@@.................@@@@@@@@@@@@...............@@@@@@@@@@@@@@@@..............
................@@@@@@@@@@@@.............@@@@@@@@@@@..................@@@@@@@@@@.............@@@@@@@@@@@@@@@@@@@@...............
..............@@@@@@@@@@@@............@@@@@@@@@@@@....................@@@@@@@@@@@.........@@@@@@@@@@@@@@@@@@@@..................
...............@@@@@@@@@@@@............@@@@@@@@@@@@.................@@@@@@@@@@@@@..........@@@@@@@@@@@@@@@@@....................
..............@@@@@@@@@@@@@@..........@@@@@@@@@@@@@@...............@@@@@@@@@@@............@@@@@@@@@@@@@@@@......................
............@@@@@@@@@@@@.............@@@@@@@@@@@................@@@@@@@@@@@@@@@@........@@@@@@@@@@@@@@@@........................
.............@@@@@@@@@@@@@...........@@@@@@@@@................@@@@@@@@@@@@@@@@@........@@@@@@@@@@@@@@@..........................
............@@@@@@@@@@@@@@..........@@@@@@@@................@@@@@@@@@@@@@@@@.........@@@@@@@@@@@................................
..........@@@@@@@@@@@@.............@@@@@@@.................@@@@@@@@@@@@@@@...........@@@@@@@@@@@@...............................
...........@@@@@@@@@@@@@...........@@@@@@@@@............@@@@@@@@@@@@@@@@@@@.........@@@@@@@@@@@@@.@@@@..........................
..........@@@@@@@@@@@@@@..........@@@@@@@@@@..........@@@@@@@@@@@@@@@@@@@@@@........@@@@@@@@@@..@@@..@@@........................
..........@@@@@@@@@@..............@@@@@@.............@@@@@@@@@@@@@@@@@@@............@@@@@@@@@@@.@@@@...@@@......................
..................................................@@@@@@@@@@@@@@@@@@@@..............@@@@@@@@@@@@@@@@@@...@@@....................
................................................@@@@@@@@@@@@@@@@@@@@@@@.................@@@@@@@@@.@@@@..@@@@....................
..............................................@@@@@@@@@@@@@@@@@@@@@@@@@@..................@@@@..@@@.....@@@@....................
...............................................@@@@@@@@@@@@@@@@@@@@@@@@.......................@@@..........@@@@@@@............@@
..................................................@@@@@@@@@@@@@@@@@@@@@@....................@@@..............@@..@@@@@@@....@@@.
................................................@@@@@@@@@@@@@@@@@@@@@@@@....................@@@....................@@..@@@@@@...
..............................................@@@@@@@@@@@@@@@@@@@@@@@@@@....................@@@@@........................@@.....
............................................@@@@@@@@@@@@@@@@@@@@@@@@..........................@@@@@@............................
..@@.........................................@@@@@@@@@@@@@@@@@@@@@..@@..........................@@@@@@..........................
..@@........................................@@@@@@@@@@@@@@@@@@@@@@@@..............................@@@@..........................
.............................................@@@@@@@@@@@@@@@@@@@@@@@@@............................@@@@..........................
........................................................@@@@@@@@@@@@@@............................@@@@@@........................
@@@@@@@@..................................................@@@@@@@@@@@@..............................@@@@@@@@@@@@@@..............
@..@@..@@@..................................................@@@@@@@@@.................................@@@@@@@@@@@@@@....@@@@....
.........@@@..............................................@@@@@@@@@@@@..................................@@@@@@@@@@@@..@@@@@@@@..
...........@@@...........................................@@@@@@@@@@@@...........................................@@@@@@@@@@@@@@@@
..........@@@@...........................................@@@@@@@@@..............................................@@@@@@@@....@@@@
..........@@@@...........................................@@@@@@@@@@@..............................................@@@@........@@
.............@@@.........................................@@@@@@@@@@@@...........................................................
...............@@@......................................@@@@@@@@@@@@@@..........................................................
..............@@@@......................................@@@@@@@@@@..............................................................
..............@@@@......................................@@@@@@@@@@@.............................................................
.................@@@...................................@@@@@@@@@@@@.............................................................
...................@@@@@@@@@@@........................@@@@@@@@@@@@@@............................................................
.....................@@..@@..@@@.......................@@@@@@@@@@@@@@@..........................................................
...............................@@@....................@@@@@@@@@@@@@@@...........................................................
.................................@@@......................@@@@@@@@..............................................................
...................................@@@..................@@@@@@@@@@@@............................................................
.....................................@@@................@@@@@@@@@@@@@...........................................................
.......................................@@@..................@@@@@@@@@...........................................................
......................................@@@@.....@@@........@@@@@@@@@@@@..........................................................
@@@@@.................................@@@@.....@@@......@@@@@@@@@@@@@.@@...................................................@@@@@
@@@@@@@@@@@@@@@@@@@@@@@@@@@@@@@@@@@@@@@@@@@@@@@@@@@@@@@@@@@@@@@@@@@@@@@@@@@@@@@@@@@@@@@@@@@@@@@@@@@@@@@@@@@@@@@@@@@@@@@@@@@@@@@@
