type octile
height 128
width 192
map
................................................................................................................................................................................................
................................................................................................................................................................................................
................................................................................................................................................................................................
..................................................................@@@@....................@@@@................@@@@@@@@@@@@......................................................................
........................................@@@@@@@@....@@@@@@@@....@@@@@@@@................@@@@@@@@............@@@@@@@@@@@@@@@@@@@@@@@@....@@@@@@@@....@@@@........................................
......................................@@@@@@@@@@@@@@@@@@@@@@@@@@@@@@@@@@@@............@@@@@@@@@@..........@@@@@@@@@@@@@@@@@@@@@@@@@@@@@@@@@@@@@@@@@@@@@@@@......................................
......................................@@@@@@@@@@@@@@@@@@@@@@@@@@@@....@@@@@@........@@@@@@..@@@@@.......@@@@@@............@@@@@@@@@@@@@@@@@@@@@@@@@@@@@@@@@@....................................
......................................@@@@......@@@@........@@@@........@@@@@@....@@@@@@....@@@@@.......@@@.........................@@@@........@@@@....@@@@@@..................................
....................................@@@@@@................................@@@@....@@@@........@@..@@....@@@@..............................................@@@@..................................
..................................@@@@@@..................................@@@@....@@@@...........@@@@@..@@@@..............................................@@@@@.................................
..................................@@@@....................................@@@@..@@@@@@..........@@@@@@@@@@@@..............................................@@@@@.................................
..............................@@@@@@@@....................................@@@@..@@@@............@@@@@@@@@@@@................................................@@..@@..............................
............................@@@@@@@@@@....................................@@@@@@@@@@...............@@@..@@@@...................................................@@@@@............................
..........................@@@@@@@@@@........................................@@@@@@@@..............@@@@..@@@@................................@@@@..............@@@@@@@@..........................
..........................@@@@....................@@@@......................@@@@@@@@..............@@@@..@@@@..............................@@@@@@@@............@@@@@@@@..........................
..........................@@@@..................@@@@@@@@....................@@@@@@@@..............@@@@@@@@@@............................@@@@....@@@@@@@@........@@@@............................
..........................@@@@.................@@@....@@@...................@@@@@@@@..............@@@@@@@@............................@@@@........@@@@@@@@@@@@@@@@..............................
............................@@@...............@@@@@@@@@@@@..................@@@@@@@@..............@@@@@@@@...........................@@@..@@@@@@@@......@@@@@@@@................................
............................@@@@..............@@@@@@@@@@@@.................@@@@@@@................@@@@@@@@..........................@@@@@@@@@@@@@@@@............................................
............................@@@@.............@@@@@@@@@@@..................@@@@@@@@..............@@@@..@@@@..........................@@@@@@@@@@@@@@@@@@@@@@........@@@@@@@@......................
............................@@@@............@@@@@@@@......................@@@@@@@@.............@@@..@@@@@@........................@@@@@@@@........@@@@@@@@@@....@@@@@@@@@@@@....................
............................@@@@............@@@@@@@@......................@@@@@@@@............@@@@@@@@@@........................@@@@..@@@@..........@@@@@@@@@@@@@@@@@@@@@@@@@@..................
................@@@@..........@@@.............@@@@@@......................@@@@@@@@............@@@@@@@@........................@@@@..@@@@@@................@@@@@@@@........@@@@@@................
..............@@@@@@@@@.......@@@@...........@@@@@@@......................@@@@@@.............@@@..@@@@.......................@@@..@@@@@@....................@@@@............@@@@................
............@@@@@@@@@@@.....@@@@@@..........@@@@@@@@......................@@@@@@@...........@@@@@@@@@@......................@@@@@@@@@@......................................@@@@@@@@............
..........@@@@@@....@@..@@..@@@@@@..........@@@@@@@@....................@@@@..@@@@..........@@@@@@@@........................@@@@@@@@........................................@@@@@@@@@@@@@@......
..........@@@@.........@@@@@..@@@@..........@@@@..@@@@................@@@@..@@@@@@..........@@@@@@..........................@.@@@@............................................@@@@@@@@@@@@@@....
..........@@@@........@@@@@@@@..@@@.........@@@@@@..@@@@............@@@@..@@@@@@............@@@@@@..........................................@@@@....................................@@@@@@@@....
........@@@@@@........@@@@@@@@..@@@@..........@@@@@@..@@@.........@@@@....@@@@.............@@@@@@@........................................@@@@@@@@@@@@.............................@@@@@@@......
......@@@@@@.............@@@..@@@@@@............@@@@@@@@@@.......@@@..@@@@@@@@............@@@@@@@@......................................@@@@....@@@@@@@@..........................@@@@@@@@......
......@@@...............@@@@..@@@.................@@@@@@@@......@@@@@@@@@@@@@@............@@@@@@@@............@@@@....................@@@@..@@@@......@@@@........................@@@@@@@@@@....
......@@@@..............@@@@..@@@@................@@@@..@@@@....@@@@@@@@@@@@..............@@@@@@.............@@@@@@..................@@@..@@@@@@@@@@@@@@@@@.....................@@@@@@@@@@@@....
......@@@@..............@@@@@@@@@@................@@@@@@..@@@@@@@@@@@@....................@@@@@@@...........@@@@@@@@................@@@@@@@@@@@@@@@@@@@@@@@@...................@@@@@@@@@@@@@....
........@@@.............@@@@@@@@....................@@@@@@..@@@@..@@@@....................@@@@@@@@..........@@@@@@@@................@@@@@@@@....@@@@@@@@@@@@..................@@@@@@@@..@@@@....
........@@@@............@@@@..@@@.....................@@@@@@....@@@@@@....................@@@@@@@@........@@@@..@@@@...............@@@..@@@@..................................@@@@@@@@..@@@@....
......@@@@@@............@@@@@@@@@@......................@@@@@@@@@@@@........................@@@@@@.......@@@..@@@@@@..............@@@@@@@@@@....................................@@@@....@@@@....
......@@@@.................@@@@@@@......................@@@@@@@@@@............................@@@@......@@@@..@@@@................@@@@@@@@............................................@@@@......
........@@@...............@@@@@@@@......................@@@@@@@@........................................@@@@..@@@@...............@@@@@@@.............................................@@@........
........@@@@..............@@@@@@@@.....................................................................@@@..@@@@@@..............@@@@..@@@...........................................@@@@........
......@@@@@@..............@@@@..@@@...................................................................@@@@..@@@.................@@@@@@@@@@..........................................@@@@........
......@@@.................@@@@@@@@@@..................................................@@@.............@@@@..@@@@..................@@@@@@@@..........................................@@@@........
......@@@@..................@@@@@@@@................................................@@@@@@...........@@@....@@@@..................@@@@@@@@..........................................@@@@........
......@@@@..................@@@@..@@@@.............................................@@@@@@@..........@@@@....@@@@..................@@@@@@@@..........................................@@@@........
......@@@@..................@@@@@@..@@@...........................................@@@@..@@@.........@@@@@@..@@@@..................@@@@..@@@.....................@@@@........@@@@....@@@@@@......
......@@@@....................@@@@@@@@@@..........................................@@@@..@@@@..........@@@@....@@@.................@@@@@@@@@@...................@@@@@@@@@@@@@@@@@@......@@@......
......@@@@......................@@@@@@@@.........................................@@@..@@@@@@..........@@@@....@@@@..................@@@@@@@@..................@@@@..@@@@@@@@..@@@@....@@@@......
....@@@@@@........................@@@@@@........................................@@@@..@@@.............@@@@..@@@@@@....................@@@@@@@.................@@@@............@@@@....@@@@@@....
....@@@.............................@@@@........................................@@@@..@@@@@@..........@@@@..@@@@......................@@@@@@@@..............@@@@................@@@@.....@@@....
....@@@@............................@@@@........................................@@@@..@@@@............@@@@....@@@@....................@@@@@@@@........@@@@@@@@......@@@@..........@@@...@@@@....
....@@@@............................@@@@........................................@@@@....@@@...........@@@@......@@@.....................@@@@@@@@....@@@@@@@@..@@@@@@@@@@@@........@@@@..@@@@....
....@@@@......................................................................@@@@......@@@@..........@@@@@@....@@@@....................@@@@..@@@@@@@@......@@@@@@@@@@@@@@........@@@@..@@@@....
....@@@@....................................................................@@@@......@@@@@@............@@@@@@..@@@@....................@@@@@@..@@@@..@@@@@@@@@@@@@@..@@@@@.........@@@@@@@@....
......@@@.................................................................@@@@......@@@@@@................@@@@....@@@@....................@@@@@@@@@@@@@@@@@@@@........@@@@@...........@@@@......
......@@@@..............................................................@@@@........@@@@..................@@@@@@@@..@@@@....................@@@@@@@@@@@@@@@@............@@..@@..................
......@@@@.............................................................@@@..........@@@@..................@@@@@@@@@@..@@@@....................@@@@@@@@.....................@@@@@................
........@@@@............................@@@@..........................@@@@........@@@@@@....................@@@@@@@@@@@@@@@...............................................@@@@@@@@..............
..........@@@@................@@@@@@@@@@@@@@@.....................@@@@@@@@........@@@.............................@@@@@@@@@@..............................................@@@@@@@@..............
............@@@@............@@@@@@@@@@@@..@@@@...................@@@@@@@..@@@@@@@@@@@@........................@.....@@@@@@@@................................................@@@@....@@..........
........@@....@@@@........@@@@............@@@@..................@@@@@@@@@@@@@@@@@@@@@@....................................................................................@@@@......@@@@........
........@@@@....@@@@@@@@@@@@..@@@@@@@@....@@@@..................@@@@@@@@@@@@@@@@@@@@..........@@@@@.................................................................@@@@@@@@..........@@........
..........@@@@....@@@@@@@@..@@@@@@@@@@@@..@@@@....................@@@@@@@@....................@@@@@@@@................................@@@@@@@@.....................@@@@@@@..@@@@@@@@............
............@@............@@@@@@@@@@@@@@@@..@@@@...............................................@@@@@@@...............................@@@@@@@@@@@..................@@@@....@@@@@@@@@@@@..........
..........................@@@..........@@@....@@@@.............................................@@@@@@@........@@@@..................@@@@......@@@@............@@@@@@@@..@@@@@@@@@@@@@@@@........
..........................@@@@........@@@@@@@@@@@@@.........................................................@@@@@@@@................@@@@@@......@@@@....@@@@@@@@@@@@..@@@@@@........@@@@@@......
....................@@@@@@@@@@........@@@@@@@@@@@@@@......................................................@@@@....@@@@................@@@@@@......@@@@@@@@@@@@......@@@@@@............@@@@@@....
.................@@@@@@@@@@@............@@@@@@@@@@@@.........@@@........................................@@@@........@@@@................@@@@........@@@@......@@@@@@@@@.................@@@@....
.................@@@@@@@@@..................................@@@@@@@@@@....@@@@........................@@@@......@@@@@@@@@@..............@@@@............@@@@@@@@@@@@@@@@................@@@@....
..............@@..@@........................................@@@@@@@@@@@@@@@@@@@@@@@@.................@@@......@@@@@@@@@@@@@.............@@@@@@@@@@@@@@@@@@@@@@@@@@@@@@@@................@@@@....
........@@@@@@@@@...........................................@@@@@@@@..@@@@....@@@@@@@@..............@@@@....@@@@@@@@@@@@@@@@..............@@@@@@@@@@@@@@@@@@@@..........................@@@@....
......@@@@@@@@@@@@..........................................@@@@@@@@@@..............@@@@............@@@@..@@@@@@........@@@@................@@@@@@@@@@@@................................@@@@....
......@@@@@@@@@@@@............................................@@@@@@@@@@..............@@@..........@@@....@@@@..........................................................................@@@@....
......@@@@..........................................................@@@@..@@@@........@@@@........@@@@....@@@@..........................................................................@@@@....
....@@@@@@................................@@@@......................@@@@@@@@@@@@......@@@@........@@@@..@@@@@@..........................................................................@@@@....
....@@@@@@@@........................@@@@@@@@@@@@....................@@@@@@@@@@@@@@....@@@@........@@@@@@@@@@........................@@@@................................................@@@@....
......@@@@@@@@@@@@............@@@@@@@@@@@@....@@@@....................@@@@....@@@@@@..@@@@........@@@@@@@@........................@@@@@@@@..............................................@@@@....
............@@@@@@@@@@@......@@@@@@@..@@@@@@@@..@@@.............................@@@@....@@@.........@@@@@@@......................@@@....@@@@@@@@........................................@@@@....
..................@@@@@@....@@@@....@@@@@@@@@@@@@@@@............................@@@@....@@@@.......@@@..@@@@....................@@@@......@@@@@@@@.....................................@@@......
....................@@@@....@@@@..@@@@@@@@@@@@@@@@@@....@@@.....................@@@@....@@@@......@@@@..@@@@....................@@@@............@@@@..................................@@@@......
......................@@@@@@@@....@@@@........@@@@@@@@@@@@@@....................@@@@....@@@@......@@@@..@@@@...................@@@..........@@@@..@@@@................................@@@@......
..............@@@@......@@@@......@@@@........@@@@..@@@@@@@@....................@@@@@@..@@@@......@@@@..@@@@..................@@@@....@@@@@@@@@@@@..@@@@.............@@@..............@@@@......
............@@@@@@@@........@@@@@@@@@@........@@@@@@..@@@@........................@@@@@@@@@@......@@@@@@@@@@..................@@@@..@@@@@@@@@@@@@@@@..@@@...........@@@@@.............@@@@......
..........@@@@@@@@@@@@@@@@@@@@@@@@@@............@@@@@@@@@@..........................@@@@@@@@........@@@@@@@@.................@@@..@@@@@@@@@@....@@@@@@@@@@..........@@@@@@............@@@@......
........@@@@@@....@@@@@@@@@@@@@@@@................@@@@@@@@..........................@@@@@@@@........@@@@..@@@...............@@@@@@@@@@............@@@@@@@@.........@@@@@@@............@@@@@@....
......@@@@@@........@@@@@@@@......................@@@@..@@@.........................@@@@@@@@........@@@@@@@@@@..............@@@@@@@@..............@@@@..@@@.......@@@@@@@@..............@@@@....
......@@@.........................................@@@@@@@@@@........................@@@@@@............@@@@@@@@.............@@@..@@@@..............@@@@..@@@@......@@@@@@@@..............@@@@....
......@@@@..........................................@@@@@@@@........................@@@@@@@.............@@@@@@............@@@@@@@@@@..............@@@@@@@@@@......@@@@..@@@.............@@@@....
....@@@@@@..........@...............................@@@@@@@@.......................@@@..@@@@............@@@@@@............@@@@@@@.................@@@@@@@@........@@@@@@@@@@............@@@@....
....@@@@............................................@@@@@@@@......................@@@@@@@@@@............@@@@..............@@@@@@@@..................@@@@@@..........@@@@@@@@............@@@@....
....@@@@...........................................@@@..@@@@......................@@@@@@@.................................@@@@@@@@..................@@@@@@.........@@@..@@@@...........@@@......
....@@@@..........................................@@@@@@@@@@........................@@@@@@................................@@@@@@@@..................@@@@..........@@@@..@@@@..........@@@@......
....@@@@..........................................@@@@@@@@.........................@@@@@@@................................@@@@@@@@..................@@@@..........@@@@@@..@@@.........@@@@......
....@@@@........................................@@@@..@@@@........................@@@@@@.................................@@@@@@@....................@@@@............@@@@..@@@@........@@@@......
......@@@.....................@@@@@@@@@@@@@@@@@@@@..@@@@@@........................@@@@..................................@@@@..@@@@.................................@@@....@@@@........@@@@@@....
......@@@@...................@@@@@@@@@@@@@@@@@@@..@@@@@@................................................................@@@@....@@@...............................@@@@......@@@@........@@@@....
......@@@@..................@@@@@@@@@@@@@@@@....@@@@@@..................................................................@@@@....@@@@..............................@@@@........@@@.......@@@@....
......@@@@..................@@@@@@@@@@@@@@@@@@@@@@@@.........................................@@@........................@@@@@@@@@@@@..............................@@@@........@@@@......@@@@....
......@@@@....................@@@@@@@@@@@@@@@@@@@@..........................................@@@@@@@@@@....................@@@@@@@@................................@@@@........@@@@......@@@@....
........@@@.................................@@@@............................................@@@@@@@@@@@@.................@@@..@@@@...............................@@@.........@@@@@......@@@@....
........@@@@..........................................................................@@@@@@@@........@@@...............@@@@..@@@@..............................@@@@.........@@@@@......@@@@....
........@@@@........................................................................@@@@@@@@@@........@@@@..............@@@@..@@@@..............................@@@@......@@..@@........@@@@....
..........@@@@@@@@..............................@.........................@@@@@@@@@@@@..@@@@@@@@......@@@@..............@@@@@@@@@@............................@@@@......@@@@@...........@@@@....
............@@@@@@@......................................................@@@@@@@@@@@..@@@@@@@@@@@@....@@@@..............@@@@@@@@............................@@@@......@@@@@@@@..........@@@@....
................@@@@....................................................@@@@....@@@@@@@@@@....@@@@@@@@@@@@..............@@@@@@@@...........................@@@........@@@@@@@@.........@@@......
................@@@@....................................................@@@@@@@@@@@@@@@@@@......@@@@@@@@................@@@@@@@@..........................@@@@..........@@@@..........@@@@......
..................@@@.........@@@@............@@@@........@@@@............@@@@@@@@@@@@@@@@......@@@@@@@@................@@@@@@@@..........................@@@@@@..........@@@@........@@@@......
..................@@@@......@@@@@@@@....@@@@@@@@@@@@.....@@@@@@.............@@@@................@@@@@@@@@@@@............@@@@@@@@............................@@@@@@..........@@@@@@@@@@@@........
..................@@@@....@@@@....@@@@@@@@@@@@....@@@@..@@@@@@@@..................................@@@@@@@@@@@@............@@@@@@@.............................@@@@............@@@@@@@@..........
....................@@@@@@@@........@@@@@@@@@@@@@@..@@@@@@@@@@@@................................@@@@........@@@..........@@@..@@@@............................@@@@..............................
......................@@@@........@@@@@@@@@@@@@@@@@@@@@@@@@@@@................................@@@@..........@@@@........@@@@..@@@@............................@@@@..............................
..................................@@@@@@@@@@@@@@@@@@@@@@@@..@@@.............................@@@@............@@@@........@@@@....@@@...........................@@@@..............................
...................................@@@@@..........@@@@@@@@@@@@@@..........................@@@@.............@@@@@........@@@@....@@@@..........................@@@@@@............................
...................................@@@@@................@@@@@@@@.........................@@@...............@@@@@........@@@@@@@@@@@@............................@@@@@@..........................
................................@@..@@....................@@@@..........................@@@@............@@..@@............@@@@@@@@................................@@@@..........................
..............................@@@@@.....................................................@@@@@@........@@@@@...............@@@@@@@@..............................@@@@............................
............................@@@@@@@@......................................................@@@@......@@@@@@@@..............@@@@@@@@............................@@@@..............................
............................@@@@@@@@......................................................@@@@......@@@@@@@@.............@@@....@@@.........................@@@@................................
............................@@@@..........................................................@@@@@@....@@@@................@@@@....@@@@..................@@@@@@@@..................................
............................@@@@............................................................@@@@....@@@@................@@@@....@@@@................@@@@@@@@....................................
..............................@@@@..........................................................@@@@....@@@@................@@@@....@@@@..............@@@@..........................................
................................@@@@@@@@@@@@....................@@@.........................@@@@....@@@@................@@@@....@@@@............@@@@............................................
..................................@@@@@@@@@@@@................@@@@@@.......................@@@......@@@@..............@@@@........@@@.........@@@@..............................................
............................................@@@@............@@@@@@@@......................@@@@......@@@@@@@@....@@@@@@@@..........@@@@......@@@@................................................
..............................................@@@@@@@@....@@@@....@@@@@@@@@@@@@@@@........@@@@........@@@@@@@@@@@@@@@@............@@@@@@@@@@@@..................................................
................................................@@@@@@@@@@@@........@@@@@@@@@@@@@@@@@@@@@@@@................@@@@....................@@@@@@@@....................................................
......................................................@@@@........................@@@@@@@@......................................................................................................
................................................................................................................................................................................................
@@@@@......................................................................................................................................................................................@@@@@
@@@@@@@@@@@@@@@@@@@@@@@@@@@@@@@@@@@@@@@@@@@@@@@@@@@@@@@@@@@@@@@@@@@@@@@@@@@@@@@@@@@@@@@@@@@@@@@@@@@@@@@@@@@@@@@@@@@@@@@@@@@@@@@@@@@@@@@@@@@@@@@@@@@@@@@@@@@@@@@@@@@@@@@@@@@@@@@@@@@@@@@@@@@@@@@@
